hombre	man
casa	house
mujer	whoman
el 	the
fuego	fire
cuando 	when
with	con
walk	camina
dead	muerte
vio	saw
tiene	has
una	a
yo i
tu	you
ella she
el	he
nostros we
trabajo work
hospital	hospital
has	tiene